mario.jpg
true
16
16
0000011111000000
0000111111111000
0000444334300000
0004343334333000
0004344333433300
0004433334444000
0000033333330000
0000441444000000
0004441441444000
0044441111444400
0033413113143300
0033311111133300
0033111111113300
0000111001110000
0004440000444000
0044440000444400