fallen_city.gif
true
16
16
9000000000000009
9090000000000909
0900000000000090
9090000000000909
9009000000009009
0000900000090000
9000090000900009
9000009009000009
0000000990000000
9000000990000009
9000009009000009
0000090000900000
9000900000090009
9009000000009009
0990000000000990
9990000000000999