mario.jpg
true
16
16
0000099999900000
0009998448999000
0099888448889900
0994884444488990
0984444444444890
9988448888448899
9888488888848889
9888488888848889
9884488888844889
9444448888444449
9449999999999449
9999889889889999
0998889889888990
0098888888888900
0099888888889900
0009999999999000
