mario.jpg
true
16
16
0000099999900000
0009998118999000
0099888118889900
0991881111188990
0981111111111890
9988118888118899
9888188888818889
9888188888818889
9881188888811889
9111118888111119
9119999999999119
9999889889889999
0998889889888990
0098888888888900
0099888888889900
0009999999999000