pole_position.gif
false
16
16
0000000000000000
0000000000000000
0000000000000000
0000000880000000
0000008888000000
0000093113900000
0000098118900000
0000008888000000
0000088888800000
0000088118800000
0000048118400000
0000048118400000
0000048118400000
0000090110900000
0000090880900000
0000008888000000