lightspeed.gif
false
16
16
1111111111111111
2222222222222222
0033000300030003
0404040404440404
0005005500550005
0606060606660606
0011010100010101
2222222222222222
0303000303030003
0044040404044044
0055050505055055
0606060606066066
0101000100011011
2222222222222222
3333333333333333
4444444444444444