sonic.gif
false
16
16
0000000000000000
9999999999999999
5555555555555555
4444444444444444
0000000000000000
9999999999999999
5555555555555555
4444444444444444
0000000000000000
9999999999999999
5555555555555555
4444444444444444
0000000000000000
9999999999999999
5555555555555555
4444444444444444