cave.gif
true
16
16
9009009009009009
3333333333333333
0900900900900900
3333333333333333
0090090090090090
3333333333333333
0009009009009009
3333333333333333
9009009009009009
3333333333333333
0900900900900900
0090090090090090
3333333333333333
0009009009009009
0000000000000000
0000000000000000